{
  "map": [
    "<________<",
    "|........|",
    "|........|",
    "|..X..X..E",
    "|........|",
    "S........|",
    "|........|",
    "|........|",
    "|........|",
    "<________<"
  ],
  "verticalSize": 10,
  "horizontalSize": 10
}